
,	,
?	.
.	.
abgemacht	fw
able	jj
about	in
about	rb
about	rp
above	in
absolutely	rb
Acapulco	np
acceptable	jj
accept	vb
accept	vbp
accessible	jj
access	nn
accommodation	nn
accommodations	nns
accomplished	vbn
accomplish	vb
according	in
accordingly	rb
accountants	nns
accounting	nn
account	nn
account	vb
acquainted	vbn
acquisitions	nns
activities	nns
activity	nn
actual	jj
actually	rb
added	jj
additional	jj
address	nn
address	vb
add	vb
add	vbp
adequately	rb
adjusted	vbn
adjust	vb
administrative	jj
a	dt
advance	nn
advantage	nn
Advent	np
advisor	nn
advisors	nns
affiliate	nn
affiliates	nns
afford	vb
afraid	jj
after	in
afternoonish	jj
afternoon	nn
afternoons	nns
after	rb
afterwards	rb
again	rb
agency	nn
agenda	nn
agent	nn
ago	rb
agreeable	jj
agreed	vbd
agreed	vbn
agreement	nn
agree	vb
agree	vbp
aha	uh
ahead	in
ahead	rb
"ahm	uh
"ah	uh
ah	uh
aim	vb
airline	nn
air	nn
airplane	nn
airport	nn
airports	nns
$A	jj
Alamo	np
Alan	np
Alberta	np
alert	jj
Alex	np
Ali	np
all	dt
Allegheny	np
$A-$L-$L-$E	ls
Allequippa	np
allergy	nn
Allied	np
$A-$L-$L	ls
all	nn
allotted	jj
allot	vb
allowed	vbn
allow	vb
all	pdt
all	rb
$A-$L	ls
almost	rb
alone	jj
along	in
along	rb
along	rp
already	rb
alright	jj
alright	uh
alrighty	jj
alrighty	uh
also	rb
Alte-Oper	np
although	in
altogether	rb
always	rb
Amanda	np
amazing	jj
amenities	nns
American-Express	np
American	jj
American	np
America	np
American-sized	jj
Americans	nps
amiable	jj
$A-$M	nn
amount	nn
amusing	jj
am	vbp
Amy	np
analysis	nn
analyzing	vbg
ancient	jj
and	cc
Andrew	np
an	dt
Andy	np
Angeles	np
angle	nn
$A	nn
Anne	np
anniversary	nn
Ann	np
annoying	jj
annual	jj
another	dt
another	nn
Anthony	np
Anuj	np
anxious	jj
anybody	nn
any	dt
anyhow	rb
anymore	rb
any	nn
anyone	nn
any	rb
anything	nn
anytime	nn
anyway	rb
anyways	rb
anywhere	rb
apart	in
apartment	nn
apart	rb
apostrophe	nn
apparently	rb
appealing	jj
appear	vb
appetizing	jj
appointment	nn
appointments	nns
appreciate	vb
appreciate	vbp
approach	vb
appropriate	jj
approval	nn
approximately	rb
April	np
Arabica	np
Arabs	nns
architect	nn
area	nn
aren't	vbp
are	vbp
arisen	vbn
arises	vbz
arise	vb
armed	jj
army	nn
Arnie	np
arose	vbd
around	in
around	rb
around	rp
arranged	vbd
arranged	vbn
arrangement	nn
arrangements	nns
arrange	vb
arrange	vbp
arranging	vbg
arrival	nn
arrived	vbd
arrived	vbn
arrive	vb
arrive	vbp
arriving	vbg
Arthur	np
artist	nn
artists	nns
art	nn
Asian	jj
aside	in
aside	rb
aside	rp
as	in
asked	vbd
asking	vbg
ask	vb
ask	vbp
asleep	jj
as	rb
assistant	nn
associates	nns
assumed	vbd
assume	vb
assume	vbp
assuming	vbg
as	uh
ate	vbd
at	in
Atlantic	np
atmosphere	nn
attending	vbg
attend	vb
attention	nn
attractive	jj
attributes	nns
Aubrey	np
auch	nn
audited	vbn
audit	nn
August	np
availability	nn
available	jj
Ava	np
avantgarde	jj
a	vbp
avenue	nn
Avenue	np
avoid	vb
awake	jj
awakes	vbz
awake	vb
aware	jj
away	rb
away	rp
awful	jj
awkward	jj
awoken	vbn
awoke	vbd
awry	jj
ay	rb
Baba	nn
Baba's	np
babe	nn
babysitting	vbg
background	nn
back	nn
back	rb
back	rp
backup	jj
backwards	rb
bad	jj
bagel	nn
baggage	nn
bags	nns
Bahamas	nps
Bahn-Card	np
bail	vb
bail	vbp
bake	nn
balcony	nn
ball	nn
Baltimore	np
bank	nn
Barbados	np
Barbara	np
Barb	np
Barck	np
barely	rb
$B-$A-$R	ls
bar	nn
barrier	nn
bars	nns
Barth's	np
Barth's	pos
Bart	np
baseball	nn
based	vbn
basement	nn
Bashford	np
basically	rb
basic	jj
basketball	nn
bath	nn
bat	nn
Bavaria	np
beaches	nns
beach	nn
Bea	np
bear	nn
bears	vbz
bear	vb
bear	vbp
beaten	vbn
beats	vbz
beat	vb
beat	vbd
beautiful	jj
became	vbd
because	in
becomes	vbz
become	vb
become	vbn
becoming	vbg
bed	nn
beds	nns
Beehive	np
been	vbn
beer	nn
beers	nns
befallen	vbn
befalls	vbz
befall	vb
befell	vbd
beforehand	rb
before	in
before	rb
began	vbd
beginning	jj
beginning	nn
beginnings	nns
beginning	vbg
begins	vbz
begin	vb
begin	vbp
begun	vbn
beheld	vbd
beheld	vbn
behind	in
behind	rb
beholds	vbz
behold	vb
being	vbg
belay	vbp
believe	vb
believe	vbp
Bellefonte	np
$B-$E-$L-$L-$E	ls
Bell	np
$B-$E-$L	ls
bench	nn
bends	vbz
bend	vb
benefit	nn
Ben	np
bent	vbd
bent	vbn
Benz	np
Berg	np
Berlin	np
$B-$E-$R	ls
besets	vbz
beset	vb
beset	vbd
beset	vbn
beside	in
besides	in
best	jjs
best	rbs
Best-Western-Hotel	np
Best-Western	np
bes	vbz
bet	nn
bets	vbz
better	jjr
better	rbr
better	vb
better	vbp
bet	vb
bet	vbd
bet	vbn
bet	vbp
between	in
between	rb
be	vb
be	vbp
beyond	in
bids	vbz
bid	vb
bid	vbd
bid	vbn
Bier	np
bigger	jjr
biggest	jjs
big	jj
bikini	nn
billing	nn
bill	nn
Bill	np
bill	vbp
Billy-Joel	np
binds	vbz
bind	vb
birds	nns
birthday	nn
bis	fw
bistro	nn
bite	nn
bites	vbz
bite	vb
bit	nn
bitten	vbn
bit	vbd
black	jj
blame	vb
bleary	jj
bled	vbd
bleeds	vbz
bleed	vb
bleed	vbn
blew	vbd
blocked	vbn
block	nn
blocks	nns
block	vb
blonde	nn
blood	nn
blowing	vbg
blown	vbn
blows	vbz
blow	vb
$B	ls
board	nn
boat	nn
Bob	np
bobsledding	jj
Bob's	pos
body	nn
bone	nn
booked	vbd
booked	vbn
book	nn
book	vb
book	vbp
bore	vbd
boring	jj
borne	vbn
boss	nn
boss's	nn
Boston	np
both	dt
bother	vb
both	nn
both	pdt
bought	vbd
bought	vbn
bounds	nns
bound	vbd
bound	vbn
Bouquet	np
box	nn
boy	nn
boy	uh
Brack	np
brain	nn
branch	nn
brand-new	jj
breakfast	nn
breaking	vbg
break	nn
breaks	vbz
break	vb
breastfed	vbd
breastfeeds	vbz
breastfeed	vb
breastfeed	vbn
breathing	nn
bred	vbd
breeds	vbz
breed	vb
breed	vbn
Brian	np
bright	jj
brilliant	jj
bringing	vbg
brings	vbz
bring	vb
bring	vbp
British-Airways	nps
broadcasts	vbz
broadcast	vb
broadcast	vbd
broadcast	vbn
Broadhead	np
brochures	nns
broken	vbn
broke	vbd
brother	nn
Brothers	nps
brought	vbd
brought	vbn
browbeats	vbz
browbeat	vb
browbeat	vbd
browbeat	vbn
Bruenhilda	np
brunch	nn
$B-$U-$B	ls
Bub	np
Bub's	np
bu	cc
B"uchner	np
buddy	nn
budget	nn
buffer	nn
buffet	nn
buff	jj
B"uhne	np
building	nn
builds	vbz
build	vb
built	vbd
built	vbn
bulkier	jjr
bullet	nn
$B-$U	ls
bummer	uh
bunch	nn
Bundesbahn	np
Bunznudders	np
bureaucracy	nn
bureau	nn
$B-$U-$R-$G	ls
burned	vbn
burns	vbz
burnt	vbd
burnt	vbn
burn	vb
bursts	vbz
burst	vb
burst	vbd
burst	vbn
Busch	np
busier	jjr
businesses	nns
business-like	jj
business	nn
bus	nn
busted	vbn
busts	vbz
bust	vb
bust	vbd
busy	jj
but	cc
but	in
butt	nn
buying	vbg
buys	vbz
buy	vb
bye	nn
bye	uh
by	in
by	rp
cable	nn
cab	nn
cafe	nn
Cafe	np
cafeteria	nn
cafeterias	nns
cakes	nns
calculating	vbg
calculation	nn
calendar	nn
calendars	nns
California	np
called	vbd
called	vbn
calling	vbg
call	nn
call	vb
call	vbp
calm	jj
calories	nns
came	vbd
campus	nn
canceling	vbg
cancellation	nn
cancel	vb
Cancun	np
can	md
cannot	md
can't	md
Canyon	np
card	nn
cards	nns
care	nn
cares	vbz
care	vb
care	vbp
Carmen	np
car	nn
Carol	np
car-pool	vb
car-pool	vbp
carries	vbz
carry	vb
cars	nns
cart	nn
case	nn
cashier	nn
cash	nn
castle	nn
casts	vbz
cast	vb
cast	vbd
cast	vbn
catching	vbg
catchs	vbz
catch	vb
catch	vbp
catchy	jj
categories	nns
category	nn
Cats	nps
caught	vbd
caught	vbn
cause	in
CeBit	np
celebrate	vbp
celebrating	vbg
celebration	nn
center	nn
central	jj
centrally	rb
Central-Station	np
certain	jj
certainly	rb
certificates	nns
chain	nn
chairs	nns
Chalfant	np
chance	nn
changed	vbn
change	nn
changes	nns
changes	vbz
change	vb
changing	nn
changing	vbg
characteristics	nns
charge	nn
Charles	np
Charlotte	np
chased          vbd
chased          vbn
chases          vbz
chase           vb
chasing         vbg
cheaper	jjr
cheapest	jjs
cheap	jj
cheating	vbg
checked	vbd
checked	vbn
check-in-desk	nn
checking	vbg
check-in	nn
checkout	nn
checks	nns
checkup	nn
check	vb
check	vbp
cheers	uh
cheese  nn
cheese  nns
Chemicals	np
chicks	nns
children	nns
chill	vb
chimney	nn
Chinese	jj
Chinese	nn
Chinese	np
chiropractor	nn
$C-$H	ls
choice	nn
choices	nns
chooses	vbz
choose	vb
choose	vbp
choosing	vbg
chosen	vbn
chose	vbd
Chris	np
Christmas-Eve	np
Christmas	np
Christy	np
chunk	nn
church	nn
Cindy	np
cities	nns
citizen	nn
city	nn
City	np
clashing	vbg
clash	vb
clash	vbp
classes	nns
class	nn
Clay	np
cleaned	vbn
clean	jj
clearing	vbg
clear	jj
clear	vb
clear	vbp
cleaves	vbz
cleave	vb
cleft	vbd
cleft	vbn
Cleveland	np
Cliffside	np
clings	vbz
cling	vb
closed	vbn
closed  vbd
close	in
close	jj
closely	rb
close	nn
close	rb
closer	jjr
closer	rbr
closest	jjs
closest	rbs
closes	vbz
closet	nn
close	vb
close	vbp
closing	nn
clothes	nns
$C	ls
club	nn
clubs	nns
clues	nns
clung	vbd
clung	vbn
coca	nn
code	nn
coffee	nn
coincides	vbz
coincide	vb
coincide	vbp
coinciding	jj
cola	nn
cold	jj
cold	nn
Colgate	np
colleague	nn
colleagues	nns
collected	vbn
collection	nn
Colleen	np
college	nn
Colorado	np
Columbus	np
comes	vbz
come	vb
come	vbn
come	vbp
comfortable	jj
comfortably	rb
comfort	nn
coming	jj
coming	vbg
commitments	nns
committed	vbn
committee	nn
commuting	nn
companies	nns
company	nn
Compaq	np
comparable	jj
compared	vbn
compare	vb
compatible	jj
compile	vb
complain	vb
complete	jj
completely	rb
complete	vb
complicated	jj
compromise	nn
computer	nn
conceivably	rb
concentrate	vb
concerned	jj
concerned	vbn
concerning	vbg
concern	nn
concerns	nns
concert	nn
concierge	fw
conclude	vb
conclusion	nn
concrete	jj
condo	nn
conducted	vbn
conductor	nn
conduct	vb
conference	nn
conferences	nns
confirmation	nn
confirmed	vbn
confirm	vb
conflicting	jj
conflict	nn
conflicts	nns
conflicts	vbz
conflict	vbp
confused	jj
confused	vbn
confusing	jj
congratulations	nns
connected	vbn
connecting	nn
connection	nn
connections	nns
connect	vb
Connie	np
consecutive	jj
considerably	rb
consideration	nn
considered	vbn
considering	vbg
consider	vb
consider	vbp
consistently	rb
conspiracy	nn
conspiring	vbg
constitutes	vbz
constraint	nn
constraints	nns
construction	nn
consult	vb
contact	nn
contact	vb
contact	vbp
continental	jj
continue	vb
continue	vbp
contract	nn
convenient	jj
conveniently	rb
convention	nn
conversation	nn
converting	vbg
cookies	nns
cool	jj
cool	uh
coordinated	vbn
coordinate	vb
copious	jj
corner	nn
corporate	jj
correct	jj
correctly	rb
costed	vbd
costed	vbn
cost	nn
costs	nns
costs	vbz
cost	vb
cost	vbp
couch	nn
could	md
couldn't	md
couldn't	vbp
counting	vbg
country	nn
counts	vbz
count	vb
county	nn
County	np
couple	nn
course	nn
Courtney	np
court	nn
covered	vbn
covers	vbz
cover	vb
cover	vbp
crack	nn
Craig	np
Cramer	np
crap	nn
crappy	jj
cream	nn
credit	nn
creeps	vbz
creep	vb
crept	vbd
crept	vbn
crew	nn
crib	vb
Cristal	np
critiques	nns
$C-$R	ls
crowded	jj
crucial	jj
$C-$S	jj
$C-$S	np
cuisine	nn
cultural	jj
culture	nn
curious	jj
current	jj
currently	rb
custom	nn
customs	nns
cute	jj
cut	jj
cut-off	nn
cuts	vbz
cutting	vbg
cut	vb
cut	vbd
cut	vbn
cut	vbp
Cyert	np
dad	nn
daily	jj
daily	rb
$D-$A	ls
Dammtor	np
Dana	np
dance	nn
danke	uh
Dan	np
Danny	np
Darlene	np
darn	uh
Daryl	np
database	nn
data	nn
date	nn
dates	nns
daughter	nn
Dave	np
day-dreaming	vbg
daylight	nn
day	nn
Day	nn
days	nns
daytime	nn
$D-$C	np
deadline	nn
deadlines	nns
deadly	jj
deaf	jj
deal	nn
deals	nns
deals	vbz
dealt	vbd
dealt	vbn
deal	vb
Debbie	np
deceivingly	rb
December	np
decent	jj
decently	rb
decided	vbd
decided	vbn
decide	vb
decide	vbp
decision	nn
decisive	jj
decrease	vb
define	vb
definitely	rb
deja	fw
delayed	vbn
delay	vb
delightful	jj
$D-$E	ls
Denny	np
Denny's	np
dental	jj
dentist	nn
Denver	np
deny	vb
departing	vbg
departmental	jj
department	nn
departure	nn
departures	nns
depart	vb
depart	vbp
depending	vbg
depends	vbz
Der-Talismann	np
deserve	vbp
designers	nns
desk	nn
despite	in
detail	nn
details	nns
determine	vb
Detroit	np
Deutschland	np
Deutsch	np
development	nn
Deville's	np
$D-$E-$V-$I-$L	ls
Devil	np
Dewitt	np
dial	vb
dictionary	nn
didn't	vbd
did	vbd
die	dt
diem	fw
Dienstag	np
diet	nn
die	vb
difference	nn
differences	nns
different	jj
differ	vbp
difficult	jj
difficulty	nn
digs	vbz
dig	vb
Diminitello's	np
Diner	nn
Diners-Club	np
dinner	nn
directions	nns
direct	jj
directly	rb
director	nn
disappointment	nn
discontinued	vbd
discount	nn
discussed	vbn
discussing	vbg
discussion	nn
discuss	vb
discuss	vbp
disk	nn
distance	nn
distracted	vbn
district	nn
disturbed	jj
dived	vbd
dived	vbn
dives	vbz
dive	vb
$D-marks	nns
$D	nn
doable	jj
doc	nn
doctor	nn
doctor's	nn
documentation	nn
documents	nns
doesn't	vbz
does	vbz
dog	nn
dogs	nns
cat     nn
cats    nns
Doherty	np
doing	vbg
doke	uh
Dolamore	np
dollars	nns
Domino's	np
donate	vb
donating	vbg
done	vbn
Don-Giovanni	np
don't	vbp
donuts	nns
Doom	np
door	nn
dorm	nn
Dortmund	np
dos	vbz
double-check	vb
double	jj
double	nn
double-sized	jj
doubles	nns
doubt	vbp
doughnuts	nns
do	vb
do	vbp
down	in
down-payment	nn
down	rb
down	rp
downstairs	rb
downtown	rb
drabs	nns
drags	vbz
drank	vbd
drawn	vbn
draws	vbz
draw	vb
dreadfully	rb
dreams	vbz
dreamt	vbd
dreamt	vbn
dream	vb
Dresden	np
drew	vbd
dribbling	nn
dribs	nns
drinking	vbg
drink	nn
drinks	nns
drinks	vbz
drink	vb
drive	nn
driven	vbn
driver	nn
drivers	nns
drives	vbz
drive	vb
drive	vbp
Dr	np
drop	vb
drove	vbd
drunk	vbn
dry	jj
$D	sym
$D-$T	ls
due	in
due	jj
dug	vbd
dug	vbn
dull	nn
dumb	jj
duration	nn
during	in
duty	nn
dwells	vbz
dwell	vb
dwelt	vbd
dwelt	vbn
each	dt
each	nn
earlier	jjr
earlier	rbr
earliest	jjs
early	jj
early	rb
ear	nn
earthly	jj
easier	jjr
easiest	jjs
easily	rb
eastern	jj
Eastern	jj
east	nn
East	np
easy	jj
eaten	vbn
eatery	nn
eating	vbg
Eat'n	np
eats	vbz
eat	vb
eat	vbp
economical	jj
economize	vb
economy	nn
$E-$D-$A	ls
edible	jj
effectively	rb
effect	nn
efficient	jj
$E-$H	ls
eight	cd
eighteen	cd
eighteenth	jj
eighth	jj
eightish	cd
eight	jj
eighty	cd
$E-$I-$N	ls
either	cc
either	dt
either	nn
either	rb
Eleanor	np
elevator	nn
elevators	nns
eleven	cd
eleven	jj
eleventh	jj
$E	ls
else	rb
elsewhere	rb
e-mail	nn
email	nn
e-mails	nns
e-mail	vb
email	vb
embarrassing	jj
Emerson	np
empty	jj
encouraging	jj
ending	vbg
end	nn
ends	vbz
end	vb
energy	nn
engaged	vbn
engagement	nn
engagements	nns
English	jj
enjoyable	jj
enjoyed	vbd
enjoyed	vbn
enjoy	vb
enjoy	vbp
$E-$N	ls
e	nn
enough	jj
enough	rb
entertainer	nn
entertaining	jj
entertainment	nn
enticing	jj
entire	jj
entirely	rb
entrance	nn
entry	nn
envy	nn
$E-$N-$Y	ls
equal	jj
Ernst-August-Platz	np
errors	nns
especially	rb
essentially	rb
estimate	vbp
etcetera	fw
Eugene	np
Euro	np
European	jj
Europe	np
Euros	nps
Eva-and-Adele	np
evaluation	nn
Eva	np
Eva-und-Adele	np
evening	nn
evenings	nns
Eve	nn
Eve	np
even	rb
event	nn
events	nns
eventually	rb
Everman	np
ever	rb
everybody	nn
everyday	nn
every	dt
everyone	nn
everything	nn
everywhere	rb
evident	jj
exact	jj
exactly	rb
example	nn
example	vbn
excellent	jj
excellent	uh
except	in
excepting	vbg
exception	nn
exchange	nn
exchange	vb
exchange	vbp
excited	jj
excited	vbn
exciting	jj
excuse	vbp
exercise	nn
exercise	vbp
exercising	vbg
ex-girlfriend	nn
exhausted	jj
exhausted	vbn
exhibition	nn
exhibitions	nns
exhibit	nn
exhibits	nns
expecting	vbg
expect	vb
expect	vbp
expedition	nn
expense	nn
expenses	nns
expensing	vbg
expensive	jj
experience	nn
experiences	nns
experiment	nn
expert	nn
explore	vb
exploring	vbg
expo	nn
Expo	np
exposure	nn
express	jj
express	nn
extended	jj
extended	vbn
extend	vb
extension	nn
extensive	jj
extent	nn
extra	jj
extremely	rb
ex-wife	nn
eyed	vbn
$E-$Y	ls
fabulous	jj
faced	vbn
face	nn
facilities	nns
fact	nn
factor	vb
faculty	nn
fairgrounds	nns
fair	jj
fairly	rb
fair	nn
fallen	vbn
fall	nn
falls	vbz
fall	vb
fall	vbp
$F-$A	ls
familiar	jj
family	nn
fantastic	jj
fantastic	uh
$F-$A-$N-$T	ls
fare	nn
farewell	uh
far	jj
far	rb
faster	jjr
fastest	jjs
fast	jj
fast	rb
favorite	jj
favorites	nns
favor	nn
fax	nn
fax	vb
fear	vbp
feasible	jj
feature	nn
features	nns
February	np
fed	vbd
feeds	vbz
feed	vb
feed	vbn
feeling	nn
feels	vbz
feel	vb
feel	vbp
fell	vbd
Felsenburg	np
felt	vbd
felt	vbn
few	jj
fifteen	cd
fifteenth	cd
fifteenth	jj
fifth	jj
Fifth	np
fifty	cd
fight	nn
fights	vbz
fight	vb
figured	vbd
figured	vbn
figure	vb
figure	vbp
figuring	vbg
filled	vbn
fill	vbp
Filofax	np
finagle	vb
finalize	vb
final	jj
finally	rb
final	nn
findings	nns
finding	vbg
finds	vbz
find	vb
find	vbp
fine	jj
fine	rb
finer	jjr
fine	uh
finished	vbd
finished	vbn
finishing	jj
finishing	vbg
finish	vb
finish	vbp
fired	vbn
firm	nn
firms	nns
first	jj
first	rb
Fischlein	np
fishing	vbg
fish	nn
fit	jj
fitness	nn
fits	vbz
fitting	vbg
fit	vb
fit	vbd
fit	vbn
five	cd
fixed	vbn
fix	nn
fix	vb
flat	jj
fled	vbd
fled	vbn
flees	vbz
flee	vb
flew	vbd
flexibility	nn
flexible	jj
flies   vbz
flight	nn
flights	nns
flings	vbz
fling	vb
flip	nn
floats	vbz
floor	nn
floors	nns
flop	nn
Florida	np
flown	vbn
$F	ls
flung	vbd
flung	vbn
flyer	nn
flying	vbg
fly	nn
flys	vbz
fly	vb
fly	vbp
F	np
focused	vbn
folks	nns
following	jj
following	vbg
follow-up	nn
fond	jj
$F-$O-$N-$T-$E	ls
food	nn
fool	nn
football	nn
footing	vbg
foot	nn
forbade	vbd
Forbes	np
forbidden	vbn
forbids	vbz
forbid	vb
forecasts	vbz
forecast	vb
forecast	vbd
forecast	vbn
foregone	vbn
foregos	vbz
forego	vb
foresaw	vbd
foreseen	vbn
foresees	vbz
foresee	vb
foretells	vbz
foretell	vb
foretold	vbd
foretold	vbn
forever	rb
forewent	vbd
forgave	vbd
forgets	vbz
forget	vb
forget	vbp
forgiven	vbn
forgives	vbz
forgive	vb
forgotten	vbn
forgot	vbd
for	in
format	nn
form	nn
forms	nns
forsaken	vbn
forsakes	vbz
forsake	vb
forsook	vbd
forth	rb
fortunately	rb
forty	cd
(for	vbd
forward	rb
forward	vb
fought	vbd
fought	vbn
found	vbd
found	vbn
four	cd
fourteen	cd
fourteenth	jj
fourth	jj
fragmented	vbn
frame	nn
France	np
Francisco	np
Frankfurt	np
frankly	rb
Frau	np
Fred's	pos
freedom	nn
free	jj
freer	jjr
free	vb
freezes	vbz
freeze	vb
frequent	jj
fresh	jj
fretting	vbg
Freyburg	np
Friday	np
Fridays	nns
Fridays	nps
friend	nn
friends	nns
frightening	jj
frills	nns
Fritzsche	np
fr	jj
$F-$R	ls
from	in
front	nn
frothy	jj
frozen	vbn
froze	vbd
frugal	jj
frustrating	jj
fuck	vb
full	jj
fully	rb
functional	jj
funding	nn
funds	nns
fun	nn
funny	jj
further	jjr
further	rbr
$F-$U-$R-$U-$I	ls
Furui	np
Furui's	np
future	nn
gaining	vbg
gain	vb
gain	vbp
Galerie-am-Stift	np
Galerie-Stift	np
gallery	nn
$G-$A	ls
game	nn
gap	nn
garage	nn
gardening	nn
Garden	np
Gary	np
gate	nn
gather	vb
gave	vbd
Gavula	np
gear	nn
gee	uh
geez	uh
GEMA	np
general	jj
generally	rb
general	nn
genital	jj
gentleman	nn
Georgengarten	np
Georg	np
Gerald	np
gerbils	nns
Gerhard	np
German	jj
German	nn
German	np
Germans	nps
Germany	np
gets	vbz
getting	vbg
get	vb
get	vbp
$G-$H	ls
gift	nn
Gilbert	np
Gillian	np
Gina	np
Ginkinspiel	np
girlfriend's	nn
Girst	np
given	vbn
gives	vbz
give	vb
give	vbp
giving	vbg
Gizla	np
glad	jj
gladly	rb
goals	nns
god	nn
god	np
God	np
god	uh
$G-$O-$E-$H	ls
Goehring	np
$G-$O-$E	ls
goes	vbz
Goettman	np
going	vbg
gold	jj
golfed	vbn
golfing	vbg
golf	nn
$G-$O	ls
gone	vbn
go	nn
goodbye	uh
good	jj
goodness	nn
goodness	uh
good	uh
gosh	uh
gos	vbz
gotten	vbn
got	vbd
got	vbn
goulash	nn
go	vb
go	vbp
government	nn
grab	vb
grab	vbp
grammar	nn
grand	jj
Grand	np
granted	vbn
graphic	nn
grasp	nn
grease	nn
great	jj
Great	np
great	uh
green	jj
greetings	nns
Greg	np
grew	vbd
Griechstrasse	np
Gries	np
grill	nn
Grill	np
grind	nn
grinds	vbz
grind	vb
$G-$R	ls
Groth-Heine	np
Groth	np
ground	nn
grounds	nns
ground	vbd
ground	vbn
group	nn
grown	vbn
grows	vbz
grow	vb
Gr"ubchen-an-der-Marktkirche	np
Gr"ubchen-at-the-market-church	np
Gr"ubchen-at-the-market	np
Guerma	np
guessing	vbg
guess	vb
guess	vbp
guide	nn
Gullifty	np
gum	uh
guru	nn
guy	nn
guys	nns
hacked	vbn
hadn't	vbd
had	vbd
had	vbn
haggard	jj
haircut	nn
hair	nn
half	jj
half	nn
half	pdt
hall	nn
Hall	np
Halloween	np
halls	nns
hallway	nn
halter	nn
halves	nns
hamburgers	nns
Hamburg	np
hammer	vb
handle	vb
hand	nn
hand	vb
handy	jj
hanger	nn
hangs	vbz
hang	vb
hang	vbp
$H-$A-$N-$N-$A	ls
Hannover	np
Hanovarians	np
Hanover	np
Hanseatics	np
Hans	np
happened	vbd
happening	nn
happening	vbg
happens	vbz
happen	vb
happen	vbp
happily	rb
happy	jj
hard	jj
$H-$A-$R-$P	ls
Harp	np
hash	vbp
hasty	jj
h"as	uh
has	vbz
hate	vb
hate	vbp
ha	uh
haul	nn
haven't	vbp
haves	vbz
have	vb
have	vbp
having	vbg
Hawaii	np
hay	nn
headed	vbn
heading	vbg
head	nn
head	vb
healthy	jj
heard	vbd
heard	vbn
hearing	vbg
hears	vbz
hear	vb
hear	vbp
heavily	rb
heck	nn
heck	uh
hectic	jj
heed	vb
Heidi	np
Heine	np
held	vbd
held	vbn
hell	nn
hello	nn
hello	uh
Helman	np
Helmuit	np
help	nn
helps	vbz
help	vb
$H-$E	ls
Helwig	np
Hemmingway's	np
hepatitis	nn
he	pp
Herald	np
here	rb
Hermann	np
herpes	nn
her	pp
her	pp$
Herr	fw
Herrmann	np
Herr	np
hers	pp$
Hertz	np
hey	uh
hidden	vbn
hides	vbz
hide	vb
hid	vbd
high	jj
Highlander	np
highly	rb
high	rb
Hillary	np
Hilton	np
him	pp
hip	jj
hired	vbd
his	pp$
hits	vbz
hit	vb
hit	vbd
hit	vbn
hit	vbp
hi	uh
$H-$L	ls
$H	ls
hm	uh
holder's	nn
hold	nn
holds	vbz
hold	vb
hold	vbp
holes	nns
holiday	nn
holidays	nns
holy	jj
home	nn
home	rb
home	rp
honest	jj
honestly	rb
honks	vbz
honk	vb
hooked	vbn
hook	vb
hoot	nn
hopefully	rb
hope	vb
hope	vbp
hoping	vbg
hopping	nn
Horke	np
horn	nn
horrendous	jj
horrible	jj
Horst	np
hosers	uh
hospital	nn
Hospitz-am-Bahnhof	np
Hospitz-at-the-station	np
hotel	nn
Hotel	nn
Hotel	np
hotels	nns
hotel-wise	rb
hot	jj
Houlihan	np
hourly	rb
hour	nn
hours	nns
house	nn
however	rb
how	wrb
huge	jj
huh	uh
human	nn
humid	jj
humor	vb
hundred	cd
hundreds	nns
hungry	jj
hung	vbd
hung	vbn
hurry	nn
hurry	vbp
hurts	vbz
hurt	vb
hurt	vbd
hurt	vbn
husband	nn
Hutsell	np
hydrobiology	nn
hyphen	nn
Ian	np
$I-$B-$M	nn
ice	nn
$I-$C-$E	np
$I-$D-$A	ls
ideal	jj
ideally	rb
idea	nn
ideas	nns
identify	vb
id	vbn
$I-$E-$S	ls
if	in
Iida	np
ike	nn
$I	ls
I	ls
imagine	vbp
immediately	rb
imperative	jj
important	jj
impossible	jj
impressed	vbn
impression	nn
improbability	nn
impromptu	jj
includes	vbz
include	vb
including	vbg
inconvenient	jj
increase	vb
incredible	jj
indeed	rb
indefinite	jj
independently	rb
Indian	jj
indifferent	jj
individual	jj
indoor	jj
inexpensive	jj
informal	jj
information	nn
informations	nns
informative	jj
in	in
in-laws	nns
Inn	np
inputs	vbz
input	vb
input	vbd
input	vbn
inquire	vb
in	rb
in	rp
insets	vbz
inset	vb
inset	vbd
inset	vbn
inside	in
inside	rb
insist	vbp
instead	in
instead	rb
insult	nn
interact	jj
interbred	vbd
interbreeds	vbz
interbreed	vb
interbreed	vbn
Intercity-Restaurant	np
interested	jj
interested	vbn
interesting	jj
interest	nn
interests	nns
interests	vbz
international	jj
interspersed	vbn
intervention	nn
interview	nn
interview	vb
interweaves	vbz
interweave	vb
interwoven	vbn
interwove	vbd
into	in
introduced	vbn
investing	vbg
invited	vbn
inviting	jj
$I-$O	ls
I	pp
Ireland	np
Irish-Over	np
irrelevant	jj
irritating	jj
island	nn
isn't	vbz
issue	nn
issues	nns
ist	nn
is	vbz
Italian	jj
Italian	np
it	pp
It	pp
itself	pp
its	pp$
Jackie	np
jacuzzi	nn
Jag	np
Jakob-and-Adele	np
James	np
jammed	jj
jammed	vbn
jam	nn
Janet	np
January	np
Japan	np
ja	uh
Jay	np
jazz	nn
Jenifer	np
Jennifer	np
Jesses	np
Jessica	np
Jess	np
Jesus	np
jet-lagged	jj
jet	nn
Jim	np
job	nn
Joe	np
Johannes	np
John	np
Johnny	np
Johnson	np
joining	vbg
joint	jj
joke	nn
$J-$O	ls
Jonathan	np
Jones	np
jot	vb
journey	nn
judgement	nn
judge	vb
juggle	vb
juicy	jj
July	np
jump	vb
Juneau	np
June	np
junky	jj
justifiable	jj
justified	vbn
just	rb
Kaiserhof-Hotel	np
Kaiserhof	np
$K-$A	ls
K"astner	np
Kavorkian	np
keen	jj
keeping	vbg
keeps	vbz
keep	vb
keep	vbp
Kennywood	np
kept	vbd
kept	vbn
Kerstin	np
Kevin	np
key	nn
kicks	vbz
kidding	vbg
kid	nn
kids	nns
Kieveta	np
kills	vbz
kill	vb
Kim	np
kind	jj
kind	nn
kinds	nns
king-size	jj
Kinter	np
kitchen	nn
Kitchen	np
Klee	np
$K-$L-$E-$I-$N	ls
Kleinschmidt	np
Kleinschmidt's	np
Kleinschmidt's	pos
$K-$L	ls
$K	ls
kneels	vbz
kneel	vb
Kneipe	fw
knelt	vbd
knelt	vbn
knew	vbd
knits	vbz
knit	vb
knit	vbd
knit	vbn
knocking	vbg
knock	vb
$K-$N-$O	ls
$K-$N-$O-$R-$R	ls
Knorr's	np
knowing	vbg
knowledge	nn
known	jj
known	vbn
knows	vbz
know	vb
know	vbp
kosher	jj
Kroepke	np
lab	nn
Labor-Day	np
ladies	nns
lady	nn
Lafayette	np
lagged	vbn
lag	nn
laid	vbd
lain	vbn
$L-$A	ls
Lamont	np
land	nn
Lane	np
language	nn
$L-$A	np
laptop	nn
largest	jjs
Larry	np
last	jj
lasts	vbz
last	vb
last	vbp
late	jj
lately	rb
late	rb
later	jjr
later	rbr
latest	jjs
latest	rbs
Latimer	np
Latin	np
latter	jj
Lauper	np
Laura	np
Lause	np
Lauser	np
lay	nn
layover	nn
lays	vbz
lay	vb
lay	vbd
lazy	jj
leading	jj
leads	vbz
lead	vb
league	nn
leaking	vbg
leans	vbz
leant	vbd
leant	vbn
lean	vb
lean	vbp
leaps	vbz
leapt	vbd
leapt	vbn
leap	vb
learns	vbz
learnt	vbd
learnt	vbn
learn	vb
least	rbs
leaves	vbz
leave	vb
leave	vbp
leaving	vbg
lecture	nn
lectures	nns
led	vbd
led	vbn
left	nn
left	rb
left	vbd
left	vbn
leg	nn
leisure	nn
$L-$E	ls
lends	vbz
lend	vb
length	nn
lenient	jj
lent	vbd
lent	vbn
Leroy	np
less	jjr
less	rbr
lets	vbz
letter	nn
letting	vbg
let	vb
let	vbd
let	vbn
let	vbp
Lew	np
library	nn
lied	vbd
lies	vbz
lie	vb
life	nn
lift	vb
lift	vbp
light	jj
lights	vbz
light	vb
liked	vbd
like	in
likely	jj
likely	rb
like	nn
like	rb
likes	vbz
like	vb
like	vbp
likewise	rb
liking	vbg
limited	jj
limited	vbn
limit	nn
limits	vbz
limo	nn
limousine	nn
Lincoln's	np
Linda	np
Linden	np
lined	vbn
line	nn
lines	nns
links	nns
$L-$I-$N	ls
Lisa	np
listed	vbn
listen	vb
listen	vbp
listings	nns
listing	vbg
list	nn
list	vb
literature	nn
little	jj
little	rb
lit	vbd
lit	vbn
live	jj
Lively	np
lives	vbz
live	vb
live	vbp
$L-$L-$E	ls
Lloyd-Webber	np
$L	ls
l	nn
loaded	vbn
load	nn
loads	nns
loathe	vbp
lobby	nn
local	jj
locally	rb
locals	nns
located	vbn
location	nn
locations	nns
Loccumer-Hof	np
Loccumer	np
logistics	nns
Lokkumer-Hof	np
Lola	np
London	np
longer	jjr
longer	rbr
long	jj
long	rb
looked	vbd
looked	vbn
looking	vbg
look	nn
looks	nns
looks	vbz
look	vb
look	vbp
Lord	np
loses	vbz
lose	vb
lose	vbp
losing	vbg
Los	np
lost	vbd
lost	vbn
lot	nn
lots	nns
lounge	nn
loved	vbd
lovely	jj
loves	vbz
love	vb
love	vbp
lower	jjr
lower	vb
lowest	jjs
low	jj
l	pp
$L-$S	ls
luck	nn
lucky	jj
Lucy	np
Lufthansa	np
luggage	nn
Luisenhof	np
luncheon	nn
lunch	nn
lunchtime	nn
luxurious	jj
luxury	nn
lying	vbg
Lyle	np
Lysander	np
machine	nn
Mac	np
made	vbd
made	vbn
Madrid	np
mail	nn
Maine	np
main	jj
mainly	rb
major	jj
make	nn
makes	vbz
make	vb
make	vbp
making	vbg
managed	vbn
management	nn
manage	vb
$M-$A-$N	ls
man	nn
Manuel	np
man	uh
many	jj
many	nn
March	np
Marcy	np
Maritim-Hotel	np
Maritim	np
marketing	nn
market	nn
marketplace	nn
mark	nn
Mark	np
marks	nns
mark	vb
married	jj
Marriott	np
Mary	np
Master-Card	np
match	nn
match	vb
material	nn
math	nn
matter	nn
matters	nns
matters	vbz
matter	vb
Matt	np
Maui	np
maximize	vb
Max	np
max	rb
maybe	rb
may	md
May	np
meal	nn
meals	nns
meaning	vbg
means	vbz
meantime	nn
meant	vbd
meant	vbn
mean	vb
mean	vbp
medium	jj
medium	nn
meeting	nn
meetings	nns
meeting	vbg
meet	nn
meets	vbz
meet	vb
meet	vbp
Meier	np
Memorial-Day	np
men	nns
mentality	nn
mentally	rb
mentioned	vbd
mentioned	vbn
mentioning	vbg
mention	vb
mention	vbp
me	pp
merely	rb
meridian	nn
message	nn
messed	vbn
mess	nn
mess	vb
mess	vbp
messy	jj
met	vbd
met	vbn
Metze	np
mhm	uh
Michael	np
midafternoon	nn
midday	nn
middle	jj
middle	nn
middling	jj
mid	jj
midnight	nn
mid-range	nn
$M-$I-$D-$T	ls
might	md
Mike	np
mile	nn
miles	nns
military	jj
military	nn
milking	vbg
$M-$I	ls
mind	nn
mind	vb
mind	vbp
mine	pp$
minimal	jj
minimum	rb
Minnesota	np
minus	in
minute	nn
minutes	nns
Miriam	np
miscommunication	nn
misheard	vbd
misheard	vbn
mishears	vbz
mishear	vb
misinterpreted	vbd
mislaid	vbd
mislaid	vbn
mislays	vbz
mislay	vb
misleads	vbz
mislead	vb
misled	vbd
misled	vbn
mispronounced	vbd
mispronouncing	vbg
misreads	vbz
misread	vb
misread	vbd
misread	vbn
missed	vbd
Misses	np
missing	vbg
mission	nn
Miss	np
misspells	vbz
misspell	vb
misspelt	vbd
misspelt	vbn
miss	vb
miss	vbp
mistake	nn
mistaken	vbn
mistakes	vbz
mistake	vb
Mister	np
mistook	vbd
misunderstands	vbz
misunderstand	vb
misunderstood	vbd
misunderstood	vbn
mixture	nn
mix	vb
$M	ls
mode	nn
modern	nn
$M-$O	ls
moment	nn
Monday	np
Mondays	nps
money	nn
Monogahela	np
Monongahela	np
monthly	jj
month	nn
months	nns
more	jjr
more	nn
more	rbr
$M-$O-$R-$I	ls
Morimoto	np
Morimoto's	np
Morimoto's	pos
$M-$O-$R	ls
morning	nn
mornings	nns
most	jjs
mostly	rb
most	nn
most	rbs
$M-$O-$T-$O	ls
Mount	np
moved	vbn
mover	nn
move	vb
move	vbp
movie	nn
movies	nns
moving	vbg
mowed	vbd
mowed	vbn
mows	vbz
mow	vb
mouse   nn
mice    nns
Mozart	np
Mr.	np
Mr	np
Mrs	np
Ms	np
much	jj
much	nn
much	rb
M"uller	np
multiply	vbp
Munich-Hannover	np
Munich	np
Murgatroyd	np
museum	nn
museums	nns
musical	nn
musicals	nns
music	nn
must	md
must	nn
mutual	jj
my	pp$
myself	pp
nah	uh
name	nn
names	nns
name	vb
name	vbp
narrow	vb
nasty	jj
Natalie	np
natural	jj
naturally	rb
nature	nn
nearest	jjs
near	in
near	jj
nearly	rb
neat	jj
necessarily	rb
necessary	jj
neck	nn
needed	vbd
needed	vbn
need	nn
needs	vbz
need	vb
need	vbp
neither	cc
neither	dt
neither	nn
neither	rb
Nelson	np
Nestroy	np
never	rb
new	jj
New	jj
New	np
New-York-City	np
New-York	np
next	in
next	jj
nice	jj
nicely	rb
nicer	jjr
niceties	nns
nice	uh
nicht	vbz
Nick	np
nightcap	nn
night	nn
nights	nns
Nils	np
nine	cd
nineish	cd
nineteen	cd
nineteenth	jj
ninety	cd
ninth	jj
nix	vb
$N	ls
Noah	np
nobody	nn
no	dt
Noehre	np
N"ohre-Hof	np
N"ohre	np
$N-$O	ls
none	nn
non-German	jj
nonrefundable	jj
non-smoking	jj
nonsmoking	jj
non-smoking	nn
nonstop	rb
noonish	jj
noon	nn
nope	uh
no	rb
normal	jj
normally	rb
north	nn
Northumberland	np
Nortons	nps
Norway	np
notebook	nn
note	nn
notes	nns
nothing	nn
noticed	vbd
noticed	vbn
notice	nn
notices	nns
notices	vbz
noticing	vbg
notify	vb
not	rb
no	uh
November	np
nowhere	rb
now	rb
number	nn
numbers	nns
Oakes	np
Oakland	np
Oakside	np
objections	nns
obligations	nns
obsession	nn
obviously	rb
occasion	nn
occupied	vbn
occur	vb
occur	vbp
o	cd
o'clock	rb
October	np
odd	jj
offering	vbg
offer	nn
offers	vbz
offer	vb
office	nn
official	jj
off	in
off	rb
off	rp
of	in
often	rb
$O-$G-$L-$E-$T-$H	ls
Oglethorpe	np
$O-$G-$L	ls
$O-$G	ls
oh	cd
oh	uh
okay	jj
okay	uh
okey	uh
old	jj
$O	ls
om	nn
once	in
once	rb
one	cd
O'Neill	np
oneish	cd
one	nn
ones	nns
on	in
only	jj
only	rb
$O	nn
on	rb
on	rp
onto	in
onward	rb
onwards	rb
oops	uh
opening	nn
openings	nns
open	jj
open	vb
opera	nn
operation	nn
opportunities	nns
opportunity	nn
opposed	vbn
opposite	jj
opposite	nn
oppressive	jj
opthamologist	nn
optimistic	jj
option	nn
options	nns
opt	vb
or	cc
order	nn
order	vb
ordinary	jj
organizational	jj
organized	vbn
organizer	nn
organize	vb
organize	vbp
organizing	vbg
originally	rb
$O-$R	ls
$O-$R-$P-$E	ls
other	jj
other	nn
otherwise	rb
ouch	uh
ought	md
ou	np
our	pp$
ourselves	pp
ours	pp$
outbids	vbz
outbid	vb
outbid	vbd
outbid	vbn
outdid	vbd
outdone	vbn
outdoors	rb
outdos	vbz
outdo	vb
outgrew	vbd
outgrown	vbn
outgrows	vbz
outgrow	vb
out	in
outlets	nns
out	nn
outran	vbd
out	rb
out	rp
outruns	vbz
outrun	vb
outrun	vbn
outsells	vbz
outsell	vb
outside	in
outside	nn
outside	rb
outskirts	nns
outsold	vbd
outsold	vbn
overate	vbd
overcame	vbd
overcasts	vbz
overcast	vb
overcast	vbd
overcast	vbn
overcomes	vbz
overcome	vb
overcome	vbn
overdid	vbd
overdone	vbn
overdos	vbz
overdo	vb
overdrawn	vbn
overdraws	vbz
overdraw	vb
overdrew	vbd
overeaten	vbn
overeats	vbz
overeat	vb
overhangs	vbz
overhang	vb
overheard	vbd
overheard	vbn
overhears	vbz
overhear	vb
overhung	vbd
overhung	vbn
over	in
overlaid	vbd
overlain	vbn
overlays	vbz
overlay	vb
overlay	vbd
overlies	vbz
overlie	vb
overnight	jj
overnight	nn
overnight	rb
over	nn
overpaid	vbd
overpaid	vbn
overpays	vbz
overpay	vb
overran	vbd
over	rb
overridden	vbn
overrides	vbz
override	vb
overrode	vbd
over	rp
overruns	vbz
overrun	vb
overrun	vbn
oversaw	vbd
overseas	rb
overseen	vbn
oversees	vbz
oversee	vb
oversells	vbz
oversell	vb
overshoots	vbz
overshoot	vb
overshot	vbd
overshot	vbn
oversleeps	vbz
oversleep	vb
overslept	vbd
overslept	vbn
oversold	vbd
oversold	vbn
overtaken	vbn
overtakes	vbz
overtake	vb
overthrew	vbd
overthrown	vbn
overthrows	vbz
overthrow	vb
overtime	nn
overtook	vbd
overview	nn
overworked	vbn
owner	nn
own	jj
own	vbp
packed	jj
packed	vbn
pack	nn
pack	vb
pack	vbp
paid	vbd
paid	vbn
painful	jj
pain	nn
painted	vbn
paintings	nns
painting	vbg
pairs	nns
palace	nn
Pamela's	np
paper	nn
papers	nns
paperwork	nn
parachute	vb
Paradise	np
pardon	vbp
parents'	nns
parents	nns
Paris	np
Parkhotel	np
parking	nn
parking	vbg
park	nn
Park	np
parks	nns
park	vb
par	nn
partaken	vbn
partakes	vbz
partake	vb
participate	vb
particular	jj
particularly	rb
partner	nn
partners	nns
part	nn
partook	vbd
partying	vbg
party	nn
party	vb
passed	vbn
passport	nn
pass	vb
past	in
past	nn
Patty	np
Paula	np
Paul	np
Pawlowski	np
paying	vbg
payment	nn
pays	vbz
pay	vb
pay	vbp
peachy	jj
Pegasus	np
$P-$E	ls
pencil	vb
pencil	vbp
pen	nn
pens	vbz
penthouse	nn
pent	vbd
pent	vbn
pen	vb
people	nns
perfect	jj
perfectly	rb
perfect	rb
performance-artists	nns
performance	nn
performed	vbn
perform	vb
per	fw
perhaps	rb
per	in
period	nn
periods	nns
personal	jj
personally	rb
person	nn
person's	nn
Pete	np
Peter	np
pet	jj
pharmaceutical	jj
Phelps	np
Philadelphia	np
Philly	np
$P-$H-$I	np
phone	nn
phone	vb
photographers	nns
phrase	nn
Piano-Man	np
piano	nn
picked	vbd
picked	vbn
picking	vbg
pick	nn
pick	vb
pick	vbp
picky	jj
picnic	nn
piece	nn
pin	nn
pin-plan	vb
pin	vb
piss	nn
Pittsburgh	np
pizza	nn
place	nn
places	nns
plane	nn
planes	nns
planned	vbn
planner	nn
planning	nn
planning	vbg
plan	nn
plans	nns
plans	vbz
plant	nn
plan	vb
plan	vbp
plastered	vbn
platform	nn
played	vbn
player	nn
playing	nn
playing	vbg
play	nn
plays	nns
play	vb
pleads	vbz
plead	vb
pleasant	jj
pleased	jj
pleased	vbn
please	rb
please	vb
pleasure	nn
pled	vbd
pled	vbn
plenty	nn
plot	nn
$P	ls
plus	in
plus	rb
$P-$M	nn
point	nn
points	nns
pooch	nn
pool	nn
pools	nns
poor	jj
poorly	rb
pop	vb
portion	nn
'	pos
posh	jj
positive	jj
possibilities	nns
possibility	nn
possible	jj
possibly	rb
postponed	vbn
postpone	vb
potential	jj
potentially	rb
pottery	nn
pouring	vbg
power	nn
$P-$P-$A	ls
practical	jj
practically	rb
preceding	jj
precisely	rb
preferable	jj
preferably	rb
preference	nn
preferences	nns
preferred	vbn
prefer	vb
prefer	vbp
prejudice	nn
prelims	nns
preparation	nn
preparations	nns
prepared	vbn
prepare	vb
preparing	vbg
presentation	nn
present	vb
pre-sets	vbz
pre-set	vb
pre-set	vbd
pre-set	vbn
president	nn
pressing	jj
pressure	nn
presume	vb
presume	vbp
presuming	vbg
pretend	vb
pretty	rb
pretzels	nns
previous	jj
previously	rb
priced	vbn
price	nn
prices	nns
pricewise	rb
pricey	jj
Primanti	np
Primanti's	np
prince	nn
print	nn
print	vb
Prinzenhof	np
prior	rb
prior	rbr
private	jj
probably	rb
problem	nn
problems	nns
proceed	vb
procrastinator	nn
production	nn
productive	jj
product	nn
Professor	np
professors	nns
profitable	jj
program	nn
progress	nn
project	nn
projects	nns
promising	jj
promptness	nn
pronounced	vbd
pronounced	vbn
pronounce	vb
pronouncing	vbg
proofreads	vbz
proofread	vb
proofread	vbd
proofread	vbn
properly	rb
proposal	nn
proposals	nns
proposed	vbn
proposes	vbz
propose	vb
proposing	vbg
proved	vbd
proven	vbn
proves	vbz
prove	vb
provided	vbd
provide	vb
public	jj
pub	nn
pubs	nns
pulled	vbd
pull	vb
purchased	vbd
purchase	vb
purchasing	vbg
purely	rb
pushed	vbn
pushing	vbg
push	vb
push	vbp
Putis	np
puts	vbz
putting	vbg
put	vb
put	vbd
put	vbn
put	vbp
$Q	ls
quality	nn
qualms	nns
quarterly	jj
quarter	nn
quarters	nns
$Q-$U-$E	ls
questionnaire	nn
question	nn
questions	nns
quicker	jjr
quickest	jjs
quick	jj
quickly	rb
quick	rb
quiet	jj
$Q-$U-$I	ls
quite	pdt
quite	rb
quiting	vbg
quits	jj
quits	vbz
quit	vb
quit	vbd
quit	vbn
race	nn
Rachel	np
Rach	np
radius	nn
railroad	nn
railway	nn
raining	vbg
random	jj
ranged	vbn
range	nn
ranges	nns
range	vbp
rang	vbd
ran	vbd
rap	vb
rate	nn
rates	nns
rather	rb
rather	vb
raunchy	jj
reach	vb
reach	vbp
reading	vbg
readjust	vb
reads	vbz
read	vb
read	vbd
read	vbn
ready	jj
ready	rb
realistic	jj
realized	vbd
realize	vb
real	jj
really	rb
real	rb
rearrange	vb
reasonable	jj
reasonably	rb
reason	nn
reasons	nns
rebinds	vbz
rebind	vb
rebound	vbd
rebound	vbn
rebuilds	vbz
rebuild	vb
rebuilt	vbd
rebuilt	vbn
re-cap	vb
recap	vb
recasts	vbz
recast	vb
recast	vbd
recast	vbn
received	vbn
receive	vb
receiving	vbg
recently	rb
recital	nn
reckon	vbp
recognize	vbp
recommendation	nn
recommendations	nns
recommended	vbd
recommended	vbn
recommends	vbz
recommend	vb
recommend	vbp
recover	vb
recover	vbp
recreational	jj
recuperate	vb
recuperating	vbg
redid	vbd
Red	np
redone	vbn
redos	vbz
redo	vb
referring	vbg
refreshed	vbn
refresh	vb
regarding	vbg
regional	jj
region	nn
regular	jj
relation	nn
relatively	rb
relatives	nns
relaxing	jj
relaxing	vbg
relax	vb
relax	vbp
re-lays	vbz
re-lay	vb
relieving	jj
religiously	rb
reluctant	jj
remade	vbd
remade	vbn
remakes	vbz
remake	vb
remarkable	jj
remarkably	rb
remember	vb
remember	vbp
reminds	vbz
remotely	rb
removed	vbn
rendering	nn
rental	jj
renting	vbg
rent	jj
rent	vb
rent	vbp
repaid	vbd
repaid	vbn
repays	vbz
repay	vb
repeating	vbg
repeat	vb
repeat	vbp
repetitious	jj
reply	vbp
report	nn
reports	nns
representation	nn
requested	vbd
requests	nns
requirements	nns
requires	vbz
reran	vbd
reruns	vbz
rerun	vb
rerun	vbn
rescheduled	vbn
reschedule	vb
rescheduling	vbg
researched	vbn
research	nn
resells	vbz
resell	vb
reservation	nn
reservations	nns
reserved	vbn
reserve	vb
reserve	vbp
resets	vbz
reset	vb
reset	vbd
reset	vbn
resold	vbd
resold	vbn
resolve	vb
resort	vb
resource	nn
resources	nn
respectable	jj
respective	jj
respectively	rb
restaurant	nn
restaurants	nns
rested	vbn
restful	jj
rest	nn
restrictions	nns
rest	vb
rest	vbp
results	nns
rethinks	vbz
rethink	vb
rethought	vbd
rethought	vbn
returning	vbg
return	nn
returns	nns
return	vb
return	vbp
$R-$E-$U-$S-$E	ls
reverse	nn
review	nn
review	vb
review	vbp
rewinds	vbz
rewind	vb
rewound	vbd
rewound	vbn
rewrites	vbz
rewrite	vb
rewritten	vbn
rewrote	vbd
Ribeau	np
Richard	np
rich	jj
Richter	np
Rickhoff	np
riday	np
ridden	vbn
ride	nn
rides	vbz
ride	vb
riding	vbg
rids	vbz
rid	vb
rid	vbd
right	jj
right	nn
righto	uh
right	rb
right	uh
$R-$I-$N-$G	ls
rings	vbz
ring	vb
risen	vbn
riser	nn
rises	vbz
rise	vb
risk	nn
ritzy	jj
river	nn
$R	ls
road	nn
Robert	np
Rob	np
rode	vbd
roger	nn
roger	rb
role	nn
Rome	np
room	nn
rooms	nns
rose	vbd
Rothenbaumchaussee	np
rough	jj
roughly	rb
rough	vb
row	nn
royal	jj
Royal	np
$R-$R	ls
rules	nns
rules	vbz
rule	vb
rung	vbn
running	vbg
runs	vbz
run	vb
run	vbn
run	vbp
rushed	vbn
rushing	vbg
rush	nn
rush	vb
Russell	np
rusty	jj
sacred	jj
sacrifices	nns
safe	jj
safer	jjr
safe	vb
said	vbd
said	vbn
salads	nns
sale	nn
same	jj
Sam	np
Sam-Sheppard	np
Sander	np
San-Diego	np
sand	nn
sang	vbd
sanity	nn
sank	vbd
San	np
satisfactory	jj
satisfied	vbn
satisfying	jj
Saturday	np
Saturdays	nps
sat	vbd
sat	vbn
sauna	nn
saunas	nns
sausage	nn
saved	vbd
save	vb
save	vbp
savings	nns
saving	vbg
sawed	vbd
saws	vbz
saw	vb
saw	vbd
saying	vbg
says	vbz
say	vb
say	vbp
Scapoff	np
Scarazzo	np
scare	vb
scar	nn
scattered	jj
scenario	nn
scene	nn
scenery	nn
scenes	nns
Schauspielhaus	np
scheduled	jj
scheduled	vbd
scheduled	vbn
schedule	nn
schedules	nns
schedules	vbz
schedule	vb
schedule	vbp
scheduling	nn
scheduling	vbg
Schenley	np
Schlosshotel	np
Schloss	nn
Schloss	np
$S-$C-$H	ls
Schmidt	np
Schneider	np
school	nn
scope	vb
Scot	np
Scott	np
screen	nn
screwed	vbd
screwed	vbn
screw	vb
scribbled	vbd
scuba	nn
sea	nn
Sean	np
season	nn
season's	nn
seat	nn
seats	nns
Seattle	np
sec	nn
second	jj
second	nn
seconds	nns
secretaries	nns
secretary	nn
section	nn
seeing	vbg
seeks	vbz
seek	vb
seemed	vbd
seems	vbz
seem	vb
seem	vbp
seen	vbn
sees	vbz
seethes	vbz
seethe	vb
see	vb
see	vbp
self	nn
sells	vbz
sell	vb
seminar	nn
seminars	nns
sends	vbz
send	vb
send	vbp
sense	nn
sensible	jj
sent	vbd
sent	vbn
separate	jj
separately	rb
September	np
sequence	nn
series	nn
serious	jj
serve	vb
serve	vbp
service	nn
session	nn
set	nn
sets	vbz
setting	nn
setting	vbg
settled	vbn
settles	vbz
settle	vb
set-up	nn
setup	vb
set	vb
set	vbd
set	vbn
set	vbp
seven	cd
seventeen	cd
seventeenth	jj
seventh	jj
sevent	jj
seventy	cd
several	dt
several	jj
severely	rb
sewed	vbd
sewn/sewed	vbn
sews	vbz
sew	vb
Seymour	np
Shady	np
Shadyside	nn
shaken	vbn
shaker	nn
shakes	vbz
shake	vb
shall	md
shalls	vbz
shall	vb
shame	nn
shareholder	nn
share	vb
sharing	vbg
shaved	vbd
shaven	vbn
shaves	vbz
shave	vb
sheared	vbd
shears	vbz
shear	vb
sheds	vbz
shed	vb
shed	vbd
shed	vbn
sheet	nn
shepherd	nn
she	pp
Sheppard	np
shift	vb
shined	vbd
shined	vbn
shines	vbz
shine	vb
shirts	nns
shit	nn
shoed/shod	vbn
shoed	vbd
shoes	vbz
shoe	vb
shook	vbd
shoots	vbz
shoot	vb
shoot	vbp
shop	nn
shopping	nn
shopping	vbg
shop	vb
shorn	vbn
short	jj
shortly	rb
shot	nn
shot	vbd
shot	vbn
should	md
shouldn't	md
should	vbd
should	vbn
showed	vbd
shower	nn
showing	nn
showing	vbg
show	nn
shown	vbn
shows	nns
shows	vbz
show	vb
show	vbp
shrinks	vbz
shrink	vb
shrunken	vbn
shrunk	vbd
shucks	uh
shuts	vbz
shuttle	nn
shut	vb
shut	vbd
shut	vbn
Siam	np
sick	jj
side	nn
Side	nn
Sie	fw
SIGgraph	np
sight	nn
sightseeing	nn
sightseeing	vbg
sights	nns
signature	nn
significant	jj
silly	jj
similar	jj
simple	jj
since	in
single	jj
single	nn
singles	nns
sings	vbz
sing	vb
sing	vbp
sinks	vbz
sink	vb
sir	nn
Sir	np
sister	nn
site	nn
sites	nns
sits	vbz
situated	vbn
situation	nn
sit	vb
sit	vbp
six	cd
sixish	cd
sixteen	cd
sixteen	jj
sixteenth	jj
sixth	jj
sixty	cd
size	nn
sizes	nns
skiing	vbg
skimped	vbn
skip	vb
skip	vbp
slain	vbn
slams	nns
slays	vbz
slay	vb
sleeping	vbg
sleep	nn
sleeps	vbz
sleep	vb
sleep	vbp
slept	vbd
slept	vbn
slew	vbd
slides	vbz
slide	vb
slid	vbd
slid	vbn
slight	jj
slightly	rb
slings	vbz
sling	vb
slips	nns
slits	vbz
slit	vb
slit	vbd
slit	vbn
slot	nn
slots	nns
$S-$L-$O-$W-$I-$G	ls
Slowig	np
Slowig's	pos
slowing	vbg
slow	jj
$S	ls
slung	vbd
slung	vbn
smaller	jjr
small	jj
smart	jj
smell	nn
smells	vbz
smell	vb
smelt	vbd
smelt	vbn
smites	vbz
smite	vb
Smith	np
smitten	vbn
smokes	vbz
smoke	vb
smoke	vbp
smoking	nn
smoking	vbg
smote	vbd
snack	nn
sneaks	vbz
sneak	vb
snuck	vbd
snuck	vbn
Snyder	np
soccer	nn
socializing	vbg
social	jj
society	nn
socket	nn
sodden	vbn
sod	vbd
sofa	nn
so	in
sold	vbd
sold	vbn
solid	jj
solution	nn
solutions	nns
somebody	nn
some	dt
somehow	rb
some	nn
someone	nn
someplace	nn
some	rb
something	nn
sometime	nn
sometimes	rb
somewhat	rb
somewhere	rb
son	nn
sooner	jjr
sooner	rbr
soon	rb
so	rb
sore	jj
sorry	jj
sorry	uh
sort	nn
sought	vbd
sought	vbn
so	uh
sounded	vbd
sound	nn
sounds	vbz
sound	vb
sound	vbp
South	jj
South	np
Soutome	np
sowed	vbd
sown	vbn
sows	vbz
sow	vb
spaced	vbn
space	nn
Spaghetti	np
span	vbd
spare	jj
spare	vb
spat	vbd
spat	vbn
speaker	nn
speaking	vbg
speaks	vbz
speak	vb
special	jj
specifically	rb
specific	jj
specifics	nns
specify	vb
sped	vbd
speeds	vbz
speed	vb
speed	vbn
spelled	vbn
spelling	nn
spelling	vbg
spells	vbz
spell	vb
spelt	vbd
spelt	vbn
spending	vbg
spends	vbz
spend	vb
spend	vbp
spent	vbd
spent	vbn
spills	vbz
spill	vb
spilt	vbd
spilt	vbn
spins	vbz
spin	vb
spirit	nn
spits	vbz
spit	vb
splits	vbz
split	vb
split	vbd
split	vbn
splurge	nn
spoils	vbz
spoilt	vbd
spoilt	vbn
spoil	vb
spoken	vbn
spoke	vbd
spontaneously	rb
spoon-fed	vbd
spoon-feeds	vbz
spoon-feed	vb
spoon-feed	vbn
sporting	nn
sport	nn
Sport-Obermier	np
sports	nns
Sports	np
's	pos
spot	nn
spots	nns
's	pp
s	pp
sprang	vbd
spread	nn
spreadsheet	nn
spreads	vbz
spread	vb
spread	vbd
spread	vbn
Sprengel-Museum	np
Sprengel	np
springs	vbz
spring	vb
sprung	vbn
spun	vbn
Square	np
squeeze	vb
squish	vb
Staatstheater	np
staff	nn
stagger	vb
stain	nn
Stairway-Queen	np
standard	jj
standard	nn
standing	vbg
stand	nn
stands	vbz
stand	vb
stank	vbd
star	nn
started	vbd
started	vbn
starting	nn
starting	vbg
start	nn
starts	vbz
start	vb
start	vbp
state	nn
States	nps
station	nn
Station	np
stations	nns
stayed	vbd
stayed	vbn
staying	vbg
stay	nn
stay	vb
stay	vbp
steak	nn
steals	vbz
steal	vb
steam	nn
Steinhuder-Meer	np
step	nn
step	vb
$S-$T-$E-$R	ls
sticks	vbz
stick	vb
stick	vbp
Stift-Museum	np
still	rb
stings	vbz
sting	vb
stinks	vbz
stink	vb
stock	nn
stolen	vbn
stole	vbd
stomach	vb
stone	nn
stood	vbd
stood	vbn
stop	nn
stopped	vbd
stopped	vbn
stop	vb
stop	vbp
storm	nn
straight	jj
straight	rb
straining	vbg
strain	nn
strain	vb
strategy	nn
stray	vb
street	nn
Street	np
stressful	jj
stress	nn
stretching	vbg
stretch	nn
stretch	vb
strewed	vbd
strewed	vbn
strews	vbz
strew	vb
stridden	vbn
strides	vbz
stride	vb
strikes	vbz
strike	vb
strings	vbz
string	vb
striven	vbn
strives	vbz
strive	vb
strode	vbd
Stromberg	np
strong	jj
strove	vbd
struck	vbd
struck	vbn
structure	nn
strung	vbd
strung	vbn
stuck	vbd
stuck	vbn
student	nn
students	nns
stuff	nn
stung	vbd
stung	vbn
stunk	vbn
stupendous	jj
stupid	jj
Stush	np
Stuttgart	np
style	nn
subtitles	nns
subtracting	vbg
subtract	vb
subtract	vbp
suburbs	nns
subway	nn
Subway	np
successful	jj
success	nn
such	dt
such	in
such	pdt
such	rb
sucker	nn
sucks	vbz
suffering	vbg
suffice	vb
Sugar	np
suggested	vbd
suggested	vbn
suggestion	nn
suggestions	nns
suggest	vb
suggest	vbp
suite	nn
suits	vbz
suit	vb
suit	vbp
Sullivan	np
summer	nn
Summers	np
Sunday	np
Sundays	nps
sung	vbn
sunk	vbn
sun	nn
sunny	jj
super	jj
superstitious	jj
support	nn
supposed	vbn
suppose	vb
suppose	vbn
suppose	vbp
sure	jj
surely	rb
sure	rb
sure	uh
surf	vb
surgery	nn
surprised	vbn
surprise	nn
surprisingly	rb
Susanne	np
sushi	nn
Susie	np
$S-$U-$S	ls
Susquehanna	np
Suzanne	np
's	vbz
swam	vbd
swears	vbz
swear	vb
sweeps	vbz
sweep	vb
swelled	vbd
swells	vbz
swell	vb
swept	vbd
swept	vbn
swimmer	nn
swimming	nn
swimming	vbg
swims	vbz
swim	vb
swings	vbz
swing	vb
switch	vb
swollen	vbn
swore	vbd
sworn	vbn
swum	vbn
swung	vbd
swung	vbn
symphony	nn
symposium	nn
system	nn
tables	nns
tab	nn
tack	vbp
Taco	np
take	nn
taken	vbn
takes	vbz
take	vb
take	vbp
taking	vbg
talked	vbd
talked	vbn
talking	vbg
talk	nn
talks	nns
talk	vb
talk	vbp
Tanaka's	np
$T-$A-$N-$A	ls
tan	nn
task	nn
tastefully	rb
taste	nn
taught	vbd
taught	vbn
taxi	nn
taxis	nns
Taylor's	np
t	cc
teachs	vbz
teach	vb
teach	vbp
team	nn
tea	nn
tears	vbz
tear	vb
technically	rb
technology	nn
teeth	nns
telephone	nn
television	nn
telling	vbg
tells	vbz
tell	vb
tell	vbp
ten	cd
tendency	nn
tend	vbp
tenish	cd
tennis	nn
tenth	jj
$T-$E-$R	ls
terms	nns
terrace	nn
terrible	jj
terribly	rb
terrific	jj
terrific	uh
Thai	np
than	in
Thanksgiving	np
thanks	uh
thanks	vbp
thank	vbp
than	rb
that	dt
that	in
that    prp
that	rb
that	wp
theater	nn
theaters	nns
the	dt
The-Hairy-Ape	np
their	pp$
them	pp
themselves	pp
then	in
then	rb
then	uh
thereabouts	rb
thereafter	rb
there	ex
therefore	rb
there	rb
these	dt
they	pp
thing	nn
things	nns
thinking	vbg
thinks	vbz
think	vb
think	vbp
third	jj
third	nn
thirds	nns
thir	jj
thirteen	cd
thirteenth	jj
thirtieth	jj
thirty	cd
thirtyish	cd
this	dt
this	rb
$T-$H	ls
Thomas	np
Thompson	np
thong	nn
those	dt
though	in
though	rb
thought	vbd
thought	vbn
thousand	cd
three	cd
threeish	cd
three	nn
threw	vbd
thriven	vbn
thrives	vbz
thrive	vb
through	in
throughout	in
through	rb
throve	vbd
thrown	vbn
throws	vbz
throw	vb
thrusts	vbz
thrust	vb
thrust	vbd
thrust	vbn
thunder	nn
Thursday	np
Thursdays	nps
ticket	nn
tickets	nns
tied	vbn
tieth	jj
tie	vb
Tiffany	np
tighter	jjr
tight	jj
tightly	rb
till	in
time	nn
times	nns
timespan	nn
time	vbp
timewise	rb
timing	nn
Timothy	np
tired	jj
tiresome	jj
tiring	jj
tissue	nn
Titanic	np
$T	ls
toast	vb
today	nn
today's	nn
together	rb
to	in
Tokyo	np
told	vbd
told	vbn
tomorrow	nn
Tom's	np
tone	vb
tonight	nn
tons	nns
took	vbd
too	rb
topic	nn
top	jj
top	nn
to	rb
tore	vbd
Tor	np
torn	vbn
Toronto	np
Torsten	np
total	jj
totally	rb
total	nn
to	to
touches	nns
touch	nn
touch	vb
tougher	jjr
tough	jj
touring	vbg
tourist	nn
tournament	nn
tour	nn
tours	nns
tour	vb
toward	in
towards	in
tower	nn
town	nn
toys	nns
track	nn
Trade-Expo	np
trade	nn
traditional	jj
tradition	nn
traffic	nn
train	nn
trains	nns
translated	vbn
transportation	nn
traveling	jj
traveling	nn
traveling	vbg
travelling	vbg
travel	nn
travel	vb
travel	vbp
treads	vbz
tread	vb
treatment	nn
treat	nn
Trevor	np
triangle	nn
triangles	nns
tricky	jj
tried	vbd
tried	vbn
tries	nns
Triple-$A	np
trip	nn
trips	nns
trodden,	vbn
trod	vbd
trouble	nn
true	jj
truly	rb
trust	vb
trust	vbp
truth	nn
trying	vbg
try	nn
try	vb
try	vbp
$T-$T-$E	ls
$T-$T	ls
tub	nn
tuckered	vbn
tuck	vbp
Tuesday	np
Tuesdays	nps
turning	vbg
turn	nn
turnout	nn
turns	nns
turns	vbz
turn	vb
turn	vbp
$T-$V	nn
twelfth	jj
twelve	cd
twelvish	cd
twen	jj
twentieth	jj
twenty	cd
twice	rb
two	cd
two	nn
type	nn
types	nns
"uber	vb
ugly	jj
u-huh	uh
$U	ls
ultimate	nn
umlaut	nn
unable	jj
unbinds	vbz
unbind	vb
unbound	vbd
unbound	vbn
uncomfortable	jj
uncool	jj
undergrad	np
under	in
underlain	vbn
underlay	vbd
underlies	vbz
underlie	vb
understanding	nn
understands	vbz
understand	vb
understand	vbp
understood	vbd
understood	vbn
undertaken	vbn
undertakes	vbz
undertake	vb
undertook	vbd
underway	rb
underwrites	vbz
underwrite	vb
underwritten	vbn
underwrote	vbd
undid	vbd
und	jj
undone	vbn
undos	vbz
undo	vb
unfamiliar	jj
unfinished	jj
unfortunate	jj
unfortunately	rb
Union	np
United	jj
United-States	nps
unless	in
unpacking	vbg
unshaven	jj
until	in
unusual	jj
unwinds	vbz
unwind	vb
unwound	vbd
unwound	vbn
upcoming	jj
upheld	vbd
upheld	vbn
upholds	vbz
uphold	vb
up	in
up	jj
up	nn
upon	in
up	rb
up	rp
upset	jj
upsets	vbz
upset	vb
upset	vbd
upset	vbn
urgent	jj
$U-$S-$A	np
used	vbd
used	vbn
useful	jj
use	nn
use	vb
using	vbg
$U-$S	np
us	pp
usual	jj
usually	rb
vacancies	nns
vacationing	vbg
vacation	nn
vacations	nns
validity	nn
valid	jj
Vandaloo	np
Vanderloo	np
variety	nn
various	jj
vegetarian	jj
vegetarian	nn
vehicle	nn
versa	rb
versus	in
very	jj
very	rb
Vet	np
via	in
vice	rb
Victoria	np
Victoria's-Secret	np
Victoria's-Secrets	nps
video	nn
videos	nns
view	jj
view	nn
$V-$I	ls
vino	fw
virtually	rb
Visa	np
visited	vbd
visiting	vbg
visit	nn
visits	nns
visits  vbz
visit	vb
vitally	rb
Vivian	np
voice	nn
Volkswagen	np
Volkswagens	nps
Volpe	np
volume	nn
vouchers	nns
vowels	nns
vu	fw
wacky	jj
$W-$A-$H-$L	ls
$W-$A-$H	ls
Wahlster	np
Wahlster's	np
Wahlster's	pos
$W-$A-$I-$B-$E-$L	ls
Waibel	np
Waibel's	np
$W-$A-$I	ls
waited	vbd
waiting	vbg
wait	vb
wait	vbp
wakes	vbz
wake	vb
wake	vbp
walking	vbg
walk	nn
walk	vb
walk	vbp
walks   vbz
walked  vbn
walked  vbd
wall	nn
Wall	np
Wally	np
$W-$A	ls
wander	vb
Wang	np
wanted	vbd
wanted	vbn
wanting	vbg
wants	vbz
want	vb
want	vbp
Warehouse	np
warm	jj
Warner	np
warning	nn
war	nn
warrant	vb
Washington	np
wash	nn
wasn't	vbd
wasted	vbd
waste	nn
waste	vbp
wasting	vbg
was	vbd
was/were	vbd
watching	vbg
watch	nn
water	nn
Water	np
Watson	np
waylaid	vbd
waylaid	vbn
waylays	vbz
waylay	vb
way	nn
ways	nns
Wean	np
wears	vbz
wear	vb
weather	nn
weaves	vbz
weave	vb
wedge	vb
Wednesday	np
Wednesdays	nns
Wednesdays	nps
weds	vbz
wed	vb
wed	vbd
wed	vbn
weekdays	nns
weekend	nn
weekends	nns
weekly	jj
weekly	rb
week	nn
weeks	nns
weeps	vbz
weep	vb
weight	nn
weights	nns
welcome	jj
welcome	vbp
well-known	jj
well	rb
well	uh
went	vbd
we	pp
wept	vbd
wept	vbn
weren't	vbd
were	vbd
west	nn
west	rb
wets	vbz
wet	vb
wet	vbd
wet	vbn
whatever	wdt
whatever	wp
whatnot	nn
what	wdt
what	wp
whenever	wrb
when	in
whens	nns
when	wrb
whereas	in
wheres	nns
wherever	wrb
where	wrb
whether	in
whichever	wdt
whichever	wp
which	wdt
which	wp
while	in
while	nn
whip	vb
whoever	wp
whole	jj
whole	nn
whom	wp
whoops	uh
who     prp
whose	wp$
who	wp
why	wrb
wicked	jj
wide	jj
wide	rb
widget	nn
wife	nn
$W-$I-$G	ls
wilco	np
Wilhelm	np
willing	jj
will	md
window	nn
windsurfing	nn
winds	vbz
wind	vb
wins	vbz
winter	nn
win	vb
wipe	vb
wise	jj
wishes	nns
wish	vb
wish	vbp
withdrawn	vbn
withdraws	vbz
withdraw	vb
withdrew	vbd
withheld	vbd
withheld	vbn
withholds	vbz
withhold	vb
with	in
within	in
without	in
withstands	vbz
withstand	vb
withstood	vbd
withstood	vbn
wives	nns
woken	vbn
woke	vbd
Wok	np
women	nns
wondered	vbd
wonderful	jj
wonderful	uh
wondering	vbg
wonder	vbp
won't	md
won't	vbp
won	vbd
won	vbn
Wooster-Group	np
word	nn
wore	vbd
workable	jj
workaholic	jj
workday	nn
workdays	nns
worked	vbd
worked	vbn
working	nn
working	vbg
work	nn
workout	nn
workplace	nn
workshop	nn
works	nns
works	vbz
work	vb
work	vbp
world	nn
worlds	nns
worn	vbn
worried	vbn
worry	vb
worse	jjr
worse	nn
worse	rbr
worth	jj
would	md
wouldn't	md
woul	md
wound	vbd
wound	vbn
woven	vbn
wove	vbd
wow	uh
Woyzeck	np
wrap	nn
wrapped	vbn
wraps	vbz
wrap	vb
wrings	vbz
wring	vb
writes	vbz
write	vb
write	vbp
written	vbn
wrong	jj
wrong	rb
wrote	vbd
wrung	vbd
wrung	vbn
$X	nn
Yamazaki	np
yards	nns
yeah	uh
yearly	jj
year	nn
Year	nn
years	nns
$Y-$E	ls
yep	uh
yesterday	nn
yes	uh
yet	rb
$Y-$E-$T-$T-$E	ls
$Y	ls
y	np
York	np
Youghiogheny	np
$Y-$O-$U	ls
you	pp
you	pp$
your	pp$
yourself	pp
yours	pp$
$Y-$R	ls
Yum	np
yup	uh
Zaphod	np
Zentralhotel-Kaiserhof	np
Zentral	np
Zentrum	np
$Z-$E-$P-$H	ls
Zephyr	np
zero	cd
zone	nn
zooming	vbg
zoo	nn
$Z	pos
